@@@@@@@@@@@@@@@@@@@@@@@@@@@@@@@@@@@@@@@@@@@@@@
                     @        @     @     @  @
@  @@@@@@@@@@@@@  @  @  @@@@  @  @  @@@@  @  @
@     @     @     @  @  @     @  @        @  @
@@@@  @  @@@@  @@@@@@@  @  @@@@  @  @@@@@@@  @
@  @  @  @     @        @        @  @        @
@  @  @  @  @@@@  @@@@@@@@@@@@@@@@  @  @@@@  @
@     @  @     @  @        @        @  @     @
@@@@@@@  @@@@  @  @  @@@@@@@  @@@@@@@  @  @@@@
@     @     @  @  @              @     @     @
@  @@@@@@@  @  @  @@@@@@@@@@  @@@@  @@@@@@@  @
@        @     @  @     @     @           @  @
@@@@@@@  @  @@@@  @  @@@@  @@@@  @@@@@@@@@@  @
@     @           @  @     @  @  @           @
@  @  @@@@  @@@@@@@  @  @@@@  @  @  @@@@@@@@@@
@  @                 @     @  @  @           @
@  @@@@@@@@@@@@@@@@@@@@@@  @  @  @@@@@@@  @  @
@           @           @     @     @     @  @
@@@@@@@@@@  @  @@@@@@@  @@@@@@@@@@  @  @@@@  @
@        @  @  @        @     @     @  @     @
@  @@@@@@@  @  @  @@@@@@@  @  @  @@@@  @  @@@@
@     @     @  @        @  @     @  @  @     @
@@@@  @  @@@@  @@@@@@@  @  @@@@@@@  @  @@@@@@@
@  @           @     @     @     @           @
@  @@@@  @  @@@@  @  @@@@@@@  @@@@@@@  @@@@  @
@        @     @  @        @           @     @
@  @@@@@@@@@@  @  @@@@@@@  @@@@@@@@@@@@@  @@@@
@     @        @     @  @     @     @  @  @  @
@@@@  @  @@@@@@@@@@  @  @@@@  @  @  @  @  @  @
@     @              @        @  @           G
@@@@@@@@@@@@@@@@@@@@@@@@@@@@@@@@@@@@@@@@@@@@@@
